------------------------------
--------------------XX--------
---XX-------------------------
---------XX-------------------
------------------------------
---------------XX-------------
-------------XX---------------
-----------XX---------XX------
---------XX-------------------
XXXXXXXXXXXXXXXXXXXXXXXXXXXXXX